111111111111111111111111111111111111111
110000000001110011111111111100011100011
100011111001110011111111110100000000001
100111010001110011111111110000111111001
100110010001110011111111111000111111001
100100010011111111111111110C01111111011
10010C010011111111111111000011111111011
101100010001111111111111000001111111001
10111101000111111111111000000011111C001
100001000001111111111100111100111111001
111101010001111111111100111100111111001
100101011111111111111100111100111111001
100001011111111111111100111100111111111
100111C00000000C00000000111110000000001
100111000111000100000000111110000000001
11P111111111111111111111111111001111001
111111111111111111111111111111101111011
111111111111111111111111111111001111001
111111111111111111111111111111001111001
111111111111111111111111111111001111101
111111111111111111111111111111011111101
111111111111111111111111111111000010C01
111111111111111111111111111111000010001
111111111111111111111111111111001111001
111111111111111111111111111111101111011
111111111111111111111111111111001111001
111111111111111111111111111111001111001
111111111111111111111111111111001111001
111111111111111111111111111111011111001
111111111111111111111111111111001111001
111111111111111111111111111111001111C01
111111111111111111111111111111100000011
111111111111111111111111111111111000011
11111111111111111111111111111111111E111
111111111111111111111111111111111111111