1111111111111111111111111111111111111111
1111111111111111111111111111111111111111
11C0000000001100000000000000000000000011
1100000000001100000000000000000000000011
110000000000110000000000000000C000000011
11000E0000001100000000000000000000000011
11000C0000001100000000000000000000000011
1100000000001100000000000000000000000011
1100000000001100001111111111110000000011
1100000000001100001111111111110000000011
11000000000011000C1100000000000000000011
1100000000001100001100000000000000000011
1100000000001100001100000000000011000011
1100000000001100001100000000000011000011
1100000000001100001100000000000011000011
1100000000001100001100000C00000011000011
110000000000C000001100110000000011000011
1100000000000000001100110000000011000011
1111111111000000001100110000000011000011
1111111111000000001100110000000011000011
11C0000011111111111100110000000011000011
1100000011111111111100110000000011000011
1100000C11000000000000110000000011000011
110000001100000C00000011000000001100C011
1100000000000000000000110000000011000011
1100000000000000000000110000000011000011
1100000000000000111111110011110011000011
110000000000000011111111001111C011000011
1100000000000000111100000011110000000011
1100000000000000111100000011110000000011
1100000000111100111100000011110000000011
110000000011110011110000C0111100000C0011
11000C0000111100111100000000000000000011
11000000001111001111C0000000000000000011
111111111111111P111111111111111111111111
1111111111111111111111111111111111111111