111111111111111111111111111111111
1C0000011111111111111111111111111
1000000111111111111111111111C1111
111111011111111111111111110001111
11000000000C00000000000C000011111
1100000000000000000000C0000001111
110111111111111111111111110000111
100000111111111111111111110000011
100000111111111111111111110000001
100000111111111111111111110000001
100001111111111111111111111011111
11P111111111111111111111111001111
111111111111111111111111111000111
111111111111111111111000100000C11
111111111111111111110000000000111
111111111111111100100000000000111
111111111111111100001000000000111
111111111111111100001111111E11111
111111111111111000011111111111111
111111111111111000011111111111111
111111111111111000111111111111111
1111111111111111C1111111111111111
111111111111111111111111111111111