11111111111111111
1000000000C000001
100100E0000000001
1P000000000000011
100000CC000000001
11111111111111111