111111111111111111
111C10011100000001
111000000000010001
1110011111111111P1
11C001111111111111
110001110001111111
111000000C00011111
111111111100000111
110011111110000011
110011111111111001
111111111111111001
111111111111111011
111111111111111011
111111111111000001
111111111110000011
111111000000000111
111C00000000100111
111111101111100111
1100C01011111C0111
110000100111110011
110C111011111110C1
110010000011111111
110011001111111111
110010011111111111
111010011111111111
110000000000000011
11100000000000C001
111111111001111001
110011111001001001
110011111001001001
111111111001111001
1001111110011111E1
10011111110C111111
111111111111111111