1111111111111111111111
111111111111C110011111
11E0011111110111001111
1110C11111C0000C000111
1110001111110010000011
1100011111111111111001
11000100C0000000001001
1110010000000000001001
1110011101110011011001
1111000000010011000001
1110011111010011100011
111C110001110011111111
1110010001110011000111
1100010000C00010000111
100011011111111010C111
1001100110000000001111
110000C100011000001111
1110000000011001111111
111111100P011111111111
1111111111111111111111